A  XXXX             XX
           X      XXXX
XXXXXXXXXXXXX XXX    X 
                     X    
 XXXXXXXXXXXXXXXXXXXXX 
                     X    
      XXXXXX         X
                     X
XXXXXXXXXXXXXXXXXXXX X  
                     X
XXXXXXX XXXXXXXXXXXXXX
           X      BXXX 
         XXX       XXX
        XXXX       XXX 
       XXXXX        XX               
      XXXXXXXXXXXX  XX
                       